9 9 1 1 6 6
0 0 0 0 0 0 0 0 0
0 1 1 1 1 1 1 0 0
0 1 0 0 0 0 1 0 0
0 1 1 0 0 0 1 0 0
0 0 1 3 3 0 1 0 0
1 1 1 0 3 0 7 0 0
1 0 0 0 1 1 1 0 0
1 0 0 0 0 0 1 0 0
1 1 1 1 1 1 1 0 0